080007001
006003000
090610020
000006000
009480003
020000500
004190008
000070000
800000030