300049000
000600501
752001000
001000700
500396000
008150096
003010060
004000100
000028000