080000900
000700100
006002004
750009000
000000006
009048003
048000030
000010000
030500800