000000000
030009050
009820013
107090000
300000045
000000006
020074000
000900000
060105400