005206000
008000100
400000060
000070000
010090080
790004000
000450008
000000719
000300004