630000081
020003000
000017430
096400570
000762000
080000600
060020000
309000060
000000009