600000304
003010500
070009000
000100073
007050600
130002000
000400020
008030900
706000008