000100000
002030000
010405000
206070300
080601040
009020607
000908010
000010700
000007000